00000000000000000000000000000000000000000000000000000000000000000000000000000000000000000000000000000000000000000000000000000000
00000000000000000000000000000000000000000000000000000000000000000000000000000000000000000000000000000000000000000000000000000000
00000000000000000000000000000000000000000000000000000000000000000000000000000000000000000000000000000000000000000000000000000000
00000000000000000000000000000000000000000000000000000000000000000000000000000000000000000000000000000000000000000000000000000000
00000000000000000000000000000000000000000000000000000000000000000000000000000000000000000000000000000000000000000000000000000000
00000000000000000000000000000000000000000000000000000000000000000000000000000000000000000000000000000000000000000000000000000000
00000000000000000000000000000000000000000000000000000000000000000000000000000000000000000000000000000000000000000000000000000000
00000000000000000000000000000000000000000000000000000000000000000000000000000000000000000000000000000000000000000000000000000000
00000000000000000000000000000000000000000000000000000000000000000000000000000000000000000000000000000000000000000000000000000000
00000000000000000000000000000000000000000000000000000000000000000000000000000000000000000000000000000000000000000000000000000000
00000000000000000000000000000000000000000000000000000000000000000000000000000000000000000000000000000000000000000000000000000000
00000000000000000000000000000000000000000000000000000000000000000000000000000000000000000000000000000000000000000000000000000000
00002222222222222222222222222222222222222222222222222222222222222222222222222222222222222222222222222222000000000000000000000000
00002222222222222222222222222222222222222222222222222222222222222222222222222222222222222222222222222222211110000000000000000000
00002222222222222222222222222222222222222222222222222222222222222222222222222222222222222222222222222222211111000000000000000000
0000222211111111111111111113111111111111131111111111111111111111111111111111111111111111111111111111111111111110000000000000000
00002221111111111111111111131111111111111311111111111111111111111111111111111111111111111111111111111111111111111100000000000000
00002221111111111111111111131111111111111311111111111111111111111111111111111111111111111111111111111111111111111111000000000000
00002221111111111111111111131111111111111311111111111111111111111111111111111111111111111111111111111111111111111111100000000000
00002221111111111111111111131111111111111311111111111111111111111111111111111111111111111111111111111111111111111111110000000000
00002221111111111111111111131111111111111311111111111111111111111111111111111111111111111111111111111111111111111111111000000000
00002221111111111111111111131111111111111311111111111111111111111111111111111111111111111111111111111111111111111111111100000000
00002221111111111111111111131111111111111311111111111111111111111111111111111111111111111111111111111111111111111111111100000000
00002221111111111111111111111111111111111111111111111111111111111111111111111111111111111111111111111111111111111111111110000000
00002221111111111111111111111111111111111111111111111111111111111111111111111111111111111111111111111111111111111111111110000000
00002221111111111111111111111111111111111111111111111111111111111111111111111111111111111111111111111111111111111111111110000000
00002221111111111111111111111111111111111111111111111111111111111111111111111111111111111111111111111111111111111111111110000000
00002221111111111111111111111111111111111111111111111133333333333333333111111111111111111111111111111111111111111111111110000000
00002221111111111111111111111111111111111111111111111111111111111111111111111111111111111111111111111111111111111111111100000000
00002221111111111111111111111111111111111111111111111111111111111111111111111111111111111111111111111111111111111111111000000000
00002221111111111111111111111111111111111111111111111111111111111111111111111111111111111111111111111111111111111111111000000000
00002221111111111111111111111111111111111111111111111111111111111111111111111111111111111111111111111111111111111111100000000000
00002221111111111111111111111111111111111111111111111111111111111111111111111111111111111111111111111111111111111111000000000000
00002221111111111111111111111111111111111111111111111111111111111111111111111111111111111111111111111111111111111100000000000000
00002222111111111111111111111111111111111111111111111111111111111111111111111111111111111111111111111111111111111000000000000000
00002222222222222222222222222222222222222222222222222222222222222222222222222222222222222222222222222222211111100000000000000000
00002222222222222222222222222222222222222222222222222222222222222222222222222222222222222222222222222222211100000000000000000000
00000222222222222222222222222222222222222222222222222222222222222222222222222222222222222222222222222222200000000000000000000000
00000000000000000000000000000000000000000000000000000000000000000000000000000000000000000000000000000000000000000000000000000000
00000000000000000000000000000000000000000000000000000000000000000000000000000000000000000000000000000000000000000000000000000000
00000000000000000000000000000000000000000000000000000000000000000000000000000000000000000000000000000000000000000000000000000000
00000000000000000000000000000000000000000000000000000000000000000000000000000000000000000000000000000000000000000000000000000000
00000000000000000000000000000000000000000000000000000000000000000000000000000000000000000000000000000000000000000000000000000000
00000000000000000000000000000000000000000000000000000000000000000000000000000000000000000000000000000000000000000000000000000000
00000000000000000000000000000000000000000000000000000000000000000000000000000000000000000000000000000000000000000000000000000000
00000000000000000000000000000000000000000000000000000000000000000000000000000000000000000000000000000000000000000000000000000000
00000000000000000000000000000000000000000000000000000000000000000000000000000000000000000000000000000000000000000000000000000000
00000000000000000000000000000000000000000000000000000000000000000000000000000000000000000000000000000000000000000000000000000000
00000000000000000000000000000000000000000000000000000000000000000000000000000000000000000000000000000000000000000000000000000000
00000000000000000000000000000000000000000000000000000000000000000000000000000000000000000000000000000000000000000000000000000001